<15,16>
(0,0)
sssssssssssssss
swww..........s
sw....i.i.....s
s.............s
s.m..m.s......s
s.............s
s.............s
s.............s
s.............s
s.............s
s.............s
s.............s
s.............s
s.............s
s.............s
sssssssssssssss
