<15,16>
(0,0)
sssssssssssssss
s.............s
s.www.i.i.....s
s..w..........s
s.m..m.s......s
s.............s
s.............s
s.............s
s...........i.s
s.............s
s.............s
s...........i.s
s.............s
s.............s
si............s
sssssssssssssss
